"ag" = (/obj/effect/landmark/underworldsafe,/turf/open/floor/fakespace,/area/rogue/under/cavewet/bogcaves/sunkencity/psydon{first_time_text = "Twilight Shores"; name = "Twilight Shores"})
"an" = (/obj/effect/wisp,/obj/structure/spacevine,/turf/open/floor/grass,/area/rogue/under/cavewet/bogcaves/sunkencity/psydon{first_time_text = "Twilight Shores"; name = "Twilight Shores"})
"as" = (/obj/structure/flora/roguetree/happyrandom{icon_state = "t6"; desc = "An old, beloved tree that even elves could love."},/turf/open/floor/grass,/area/rogue/under/cavewet/bogcaves/sunkencity/psydon{first_time_text = "Twilight Shores"; name = "Twilight Shores"})
"aY" = (/turf/open/floor/rogue/naturalstone,/area/rogue/under/cavewet/bogcaves/sunkencity/psydon{first_time_text = "Twilight Shores"; name = "Twilight Shores"})
"bn" = (/obj/structure/underworld/carriage{pixel_x = -100},/turf/open/floor/rogue/blocks/stone/stonepattern3,/area/rogue/under/cavewet/bogcaves/sunkencity/psydon{first_time_text = "Twilight Shores"; name = "Twilight Shores"})
"bC" = (/turf/closed/wall/mineral/rogue/stone/moss,/area/rogue/under/cavewet/bogcaves/sunkencity/psydon{first_time_text = "Twilight Shores"; name = "Twilight Shores"})
"bL" = (/obj/structure/flora/grass/jungle/b,/turf/open/floor/rogue/dirt,/area/rogue/under/cavewet/bogcaves/sunkencity/psydon{first_time_text = "Twilight Shores"; name = "Twilight Shores"})
"ds" = (/obj/machinery/light/rogue/wallfire/candle/blue/l,/obj/structure/spacevine,/obj/structure/flora/grass/jungle/b,/turf/open/floor/rogue/ruinedwood/spiral,/area/rogue/under/cavewet/bogcaves/sunkencity/psydon{first_time_text = "Twilight Shores"; name = "Twilight Shores"})
"dw" = (/obj/structure/flora/grass/jungle/b,/turf/open/water/cleanshallow,/area/rogue/under/cavewet/bogcaves/sunkencity/psydon{first_time_text = "Twilight Shores"; name = "Twilight Shores"})
"dx" = (/obj/structure/flora/grass/jungle/b,/turf/open/floor/grass,/area/rogue/under/cavewet/bogcaves/sunkencity/psydon{first_time_text = "Twilight Shores"; name = "Twilight Shores"})
"dA" = (/obj/structure/spacevine,/obj/structure/closet/crate/chest,/obj/item/natural/feather,/obj/item/natural/feather,/obj/item/paper/scroll,/obj/item/paper/scroll,/obj/item/paper/scroll,/obj/item/paper/scroll,/obj/item/paper/scroll,/turf/open/floor/rogue/ruinedwood/spiral,/area/rogue/under/cavewet/bogcaves/sunkencity/psydon{first_time_text = "Twilight Shores"; name = "Twilight Shores"})
"dO" = (/obj/structure/flora/grass/jungle/b,/turf/open/floor/rogue/ruinedwood/spiral,/area/rogue/under/cavewet/bogcaves/sunkencity/psydon{first_time_text = "Twilight Shores"; name = "Twilight Shores"})
"dP" = (/obj/structure/flora/roguetree/happyrandom{icon_state = "t3"; desc = "An old, beloved tree that even elves could love."},/turf/open/water/cleanshallow,/area/rogue/under/cavewet/bogcaves/sunkencity/psydon{first_time_text = "Twilight Shores"; name = "Twilight Shores"})
"fa" = (/obj/structure/flora/grass/jungle/b,/turf/open/floor/rogue/blocks/stone/stonepattern3,/area/rogue/under/cavewet/bogcaves/sunkencity/psydon{first_time_text = "Twilight Shores"; name = "Twilight Shores"})
"ft" = (/obj/structure/flora/roguetree/underworld,/turf/open/water/cleanshallow,/area/rogue/under/cavewet/bogcaves/sunkencity/psydon{first_time_text = "Twilight Shores"; name = "Twilight Shores"})
"fA" = (/obj/structure/flora/junglebush/c,/turf/open/floor/grass,/area/rogue/under/cavewet/bogcaves/sunkencity/psydon{first_time_text = "Twilight Shores"; name = "Twilight Shores"})
"gB" = (/obj/effect/landmark/underworldcoin,/turf/open/floor/grass,/area/rogue/under/cavewet/bogcaves/sunkencity/psydon{first_time_text = "Twilight Shores"; name = "Twilight Shores"})
"gD" = (/turf/open/floor/fakespace,/area/rogue/under/cavewet/bogcaves/sunkencity/psydon{first_time_text = "Twilight Shores"; name = "Twilight Shores"})
"hX" = (/obj/effect/wisp,/obj/structure/flora/ausbushes/brflowers,/turf/open/floor/grass,/area/rogue/under/cavewet/bogcaves/sunkencity/psydon{first_time_text = "Twilight Shores"; name = "Twilight Shores"})
"hZ" = (/obj/structure/underworld/barrier,/turf/open/floor/rogue/cobblerock,/area/rogue/under/cavewet/bogcaves/sunkencity/psydon{first_time_text = "Twilight Shores"; name = "Twilight Shores"})
"iu" = (/obj/machinery/light/rogue/wallfire/candle/blue,/obj/structure/closet/crate/roguecloset/lord,/obj/item/reagent_containers/glass/bottle/rogue/wine,/obj/item/reagent_containers/glass/bottle/rogue/wine,/obj/item/reagent_containers/glass/bottle/rogue/wine,/obj/item/reagent_containers/glass/bottle/rogue/wine,/obj/item/reagent_containers/glass/bottle/rogue/wine,/turf/open/floor/rogue/ruinedwood/spiral,/area/rogue/under/cavewet/bogcaves/sunkencity/psydon{first_time_text = "Twilight Shores"; name = "Twilight Shores"})
"iN" = (/turf/open/water/cleanshallow,/area/rogue/under/cavewet/bogcaves/sunkencity/psydon{first_time_text = "Twilight Shores"; name = "Twilight Shores"})
"jd" = (/obj/effect/landmark/underworld,/turf/open/floor/rogue/cobblerock,/area/rogue/under/cavewet/bogcaves/sunkencity/psydon{first_time_text = "Twilight Shores"; name = "Twilight Shores"})
"jh" = (/obj/structure/chair/bench{dir = 8},/turf/open/floor/rogue/blocks/stone/stonepattern3,/area/rogue/under/cavewet/bogcaves/sunkencity/psydon{first_time_text = "Twilight Shores"; name = "Twilight Shores"})
"jC" = (/obj/effect/wisp,/turf/open/water/cleanshallow,/area/rogue/under/cavewet/bogcaves/sunkencity/psydon{first_time_text = "Twilight Shores"; name = "Twilight Shores"})
"kj" = (/obj/structure/flora/roguetree/burnt,/turf/open/water/cleanshallow,/area/rogue/under/cavewet/bogcaves/sunkencity/psydon{first_time_text = "Twilight Shores"; name = "Twilight Shores"})
"kO" = (/obj/structure/flora/roguetree/happyrandom,/turf/open/floor/rogue/dirt,/area/rogue/under/cavewet/bogcaves/sunkencity/psydon{first_time_text = "Twilight Shores"; name = "Twilight Shores"})
"kP" = (/obj/structure/spacevine,/turf/open/floor/rogue/dirt,/area/rogue/under/cavewet/bogcaves/sunkencity/psydon{first_time_text = "Twilight Shores"; name = "Twilight Shores"})
"li" = (/turf/closed/wall/mineral/rogue/wooddark,/area/rogue/under/cavewet/bogcaves/sunkencity/psydon{first_time_text = "Twilight Shores"; name = "Twilight Shores"})
"nd" = (/obj/structure/flora/roguetree/underworld,/obj/structure/flora/roguetree/underworld,/turf/open/water/cleanshallow,/area/rogue/under/cavewet/bogcaves/sunkencity/psydon{first_time_text = "Twilight Shores"; name = "Twilight Shores"})
"np" = (/obj/structure/flora/grass/jungle/b,/obj/machinery/light/rogue/firebowl/standing/blue,/turf/open/floor/grass,/area/rogue/under/cavewet/bogcaves/sunkencity/psydon{first_time_text = "Twilight Shores"; name = "Twilight Shores"})
"nV" = (/obj/machinery/light/rogue/wallfire/candle/blue/l,/turf/open/floor/rogue/ruinedwood/spiral,/area/rogue/under/cavewet/bogcaves/sunkencity/psydon{first_time_text = "Twilight Shores"; name = "Twilight Shores"})
"pu" = (/obj/structure/flora/grass/jungle/b,/obj/effect/wisp,/turf/open/floor/rogue/naturalstone,/area/rogue/under/cavewet/bogcaves/sunkencity/psydon{first_time_text = "Twilight Shores"; name = "Twilight Shores"})
"pD" = (/obj/structure/flora/grass/jungle/b,/obj/effect/wisp,/turf/open/floor/rogue/blocks/stone/stonepattern3,/area/rogue/under/cavewet/bogcaves/sunkencity/psydon{first_time_text = "Twilight Shores"; name = "Twilight Shores"})
"pN" = (/obj/machinery/light/rogue/firebowl/standing/blue,/turf/open/floor/grass,/area/rogue/under/cavewet/bogcaves/sunkencity/psydon{first_time_text = "Twilight Shores"; name = "Twilight Shores"})
"qk" = (/obj/structure/flora/grass/jungle,/turf/open/floor/grass,/area/rogue/under/cavewet/bogcaves/sunkencity/psydon{first_time_text = "Twilight Shores"; name = "Twilight Shores"})
"qH" = (/obj/effect/landmark/underworldsafe,/obj/machinery/light/rogue/firebowl/standing/blue,/turf/open/floor/grass,/area/rogue/under/cavewet/bogcaves/sunkencity/psydon{first_time_text = "Twilight Shores"; name = "Twilight Shores"})
"qI" = (/obj/machinery/light/rogue/firebowl/standing/blue,/turf/open/floor/rogue/cobblerock,/area/rogue/under/cavewet/bogcaves/sunkencity/psydon{first_time_text = "Twilight Shores"; name = "Twilight Shores"})
"qK" = (/obj/effect/landmark/underworldsafe,/turf/open/floor/grass,/area/rogue/under/cavewet/bogcaves/sunkencity/psydon{first_time_text = "Twilight Shores"; name = "Twilight Shores"})
"qT" = (/obj/structure/flora/ausbushes/brflowers,/turf/open/floor/grass,/area/rogue/under/cavewet/bogcaves/sunkencity/psydon{first_time_text = "Twilight Shores"; name = "Twilight Shores"})
"rr" = (/obj/item/reagent_containers/glass/cup/skull,/obj/item/reagent_containers/glass/cup/skull,/obj/item/reagent_containers/glass/cup/skull,/obj/item/reagent_containers/glass/cup/skull,/obj/item/reagent_containers/glass/cup/skull,/obj/structure/table/wood,/turf/open/floor/rogue/ruinedwood/spiral,/area/rogue/under/cavewet/bogcaves/sunkencity/psydon{first_time_text = "Twilight Shores"; name = "Twilight Shores"})
"rM" = (/obj/machinery/light/rogue/wallfire/candle/blue/r,/obj/structure/flora/grass/jungle/b,/turf/open/floor/rogue/ruinedwood/spiral,/area/rogue/under/cavewet/bogcaves/sunkencity/psydon{first_time_text = "Twilight Shores"; name = "Twilight Shores"})
"rU" = (/obj/structure/mineral_door/wood/fancywood,/turf/open/floor/rogue/ruinedwood/spiral,/area/rogue/under/cavewet/bogcaves/sunkencity/psydon{first_time_text = "Twilight Shores"; name = "Twilight Shores"})
"sp" = (/obj/effect/wisp,/obj/structure/flora/grass/jungle,/turf/open/floor/grass,/area/rogue/under/cavewet/bogcaves/sunkencity/psydon{first_time_text = "Twilight Shores"; name = "Twilight Shores"})
"st" = (/obj/effect/wisp,/turf/open/floor/rogue/blocks/stone/stonepattern3,/area/rogue/under/cavewet/bogcaves/sunkencity/psydon{first_time_text = "Twilight Shores"; name = "Twilight Shores"})
"td" = (/obj/structure/flora/roguetree/underworld,/turf/open/floor/rogue/dirt,/area/rogue/under/cavewet/bogcaves/sunkencity/psydon{first_time_text = "Twilight Shores"; name = "Twilight Shores"})
"uE" = (/obj/effect/wisp,/turf/open/floor/grass,/area/rogue/under/cavewet/bogcaves/sunkencity/psydon{first_time_text = "Twilight Shores"; name = "Twilight Shores"})
"wc" = (/obj/machinery/light/rogue/wallfire/candle/blue,/obj/structure/closet/crate/roguecloset/lord,/obj/item/reagent_containers/glass/bottle/rogue/milk,/obj/item/reagent_containers/glass/bottle/rogue/milk,/obj/structure/flora/grass/jungle/b,/obj/item/reagent_containers/glass/bottle/rogue/milk,/obj/item/reagent_containers/glass/bottle/rogue/milk,/obj/item/reagent_containers/glass/bottle/rogue/milk,/turf/open/floor/rogue/ruinedwood/spiral,/area/rogue/under/cavewet/bogcaves/sunkencity/psydon{first_time_text = "Twilight Shores"; name = "Twilight Shores"})
"wp" = (/obj/structure/flora/roguetree/underworld,/obj/structure/spacevine,/turf/open/water/cleanshallow,/area/rogue/under/cavewet/bogcaves/sunkencity/psydon{first_time_text = "Twilight Shores"; name = "Twilight Shores"})
"wx" = (/turf/closed/wall/mineral/rogue/wooddark/window,/area/rogue/under/cavewet/bogcaves/sunkencity/psydon{first_time_text = "Twilight Shores"; name = "Twilight Shores"})
"xa" = (/obj/structure/flora/roguetree/underworld,/obj/structure/spacevine,/turf/open/floor/grass,/area/rogue/under/cavewet/bogcaves/sunkencity/psydon{first_time_text = "Twilight Shores"; name = "Twilight Shores"})
"xZ" = (/obj/structure/flora/roguetree/stump/log,/turf/open/floor/grass,/area/rogue/under/cavewet/bogcaves/sunkencity/psydon{first_time_text = "Twilight Shores"; name = "Twilight Shores"})
"yr" = (/obj/structure/flora/grass/jungle/b,/turf/open/floor/rogue/naturalstone,/area/rogue/under/cavewet/bogcaves/sunkencity/psydon{first_time_text = "Twilight Shores"; name = "Twilight Shores"})
"yA" = (/obj/effect/wisp,/obj/structure/flora/grass/jungle/b,/turf/open/floor/grass,/area/rogue/under/cavewet/bogcaves/sunkencity/psydon{first_time_text = "Twilight Shores"; name = "Twilight Shores"})
"yL" = (/obj/structure/flora/grass/jungle{icon_state = "grassa2"},/turf/open/water/cleanshallow,/area/rogue/under/cavewet/bogcaves/sunkencity/psydon{first_time_text = "Twilight Shores"; name = "Twilight Shores"})
"yN" = (/obj/structure/underworld/carriageman{pixel_x = -15; pixel_y = -20},/turf/open/floor/grass,/area/rogue/under/cavewet/bogcaves/sunkencity/psydon{first_time_text = "Twilight Shores"; name = "Twilight Shores"})
"za" = (/obj/structure/flora/grass/jungle{icon_state = "grassa1"},/turf/open/floor/grass,/area/rogue/under/cavewet/bogcaves/sunkencity/psydon{first_time_text = "Twilight Shores"; name = "Twilight Shores"})
"zp" = (/obj/effect/wisp,/turf/open/floor/rogue/dirt,/area/rogue/under/cavewet/bogcaves/sunkencity/psydon{first_time_text = "Twilight Shores"; name = "Twilight Shores"})
"zA" = (/obj/effect/wisp,/turf/open/floor/rogue/cobblerock,/area/rogue/under/cavewet/bogcaves/sunkencity/psydon{first_time_text = "Twilight Shores"; name = "Twilight Shores"})
"At" = (/obj/effect/wisp,/turf/open/floor/fakespace,/area/rogue/under/cavewet/bogcaves/sunkencity/psydon{first_time_text = "Twilight Shores"; name = "Twilight Shores"})
"AA" = (/obj/effect/landmark/underworldsafe,/turf/open/water/cleanshallow,/area/rogue/under/cavewet/bogcaves/sunkencity/psydon{first_time_text = "Twilight Shores"; name = "Twilight Shores"})
"AE" = (/turf/closed/wall/shroud,/area/rogue/under/cavewet/bogcaves/sunkencity/psydon{first_time_text = "Twilight Shores"; name = "Twilight Shores"})
"AW" = (/obj/structure/flora/roguetree/underworld,/turf/open/floor/grass,/area/rogue/under/cavewet/bogcaves/sunkencity/psydon{first_time_text = "Twilight Shores"; name = "Twilight Shores"})
"Bn" = (/turf/closed/wall/mineral/rogue/wooddark/horizontal,/area/rogue/under/cavewet/bogcaves/sunkencity/psydon{first_time_text = "Twilight Shores"; name = "Twilight Shores"})
"Bt" = (/obj/effect/landmark/underworldcoin,/turf/open/floor/rogue/dirt,/area/rogue/under/cavewet/bogcaves/sunkencity/psydon{first_time_text = "Twilight Shores"; name = "Twilight Shores"})
"BZ" = (/obj/structure/flora/roguetree/happyrandom{icon_state = "t3"; desc = "An old, beloved tree that even elves could love."},/turf/open/floor/grass,/area/rogue/under/cavewet/bogcaves/sunkencity/psydon{first_time_text = "Twilight Shores"; name = "Twilight Shores"})
"CN" = (/obj/structure/chair/stool/rogue,/turf/open/floor/rogue/ruinedwood/spiral,/area/rogue/under/cavewet/bogcaves/sunkencity/psydon{first_time_text = "Twilight Shores"; name = "Twilight Shores"})
"DH" = (/obj/structure/underworld/barrier,/turf/open/water/cleanshallow,/area/rogue/under/cavewet/bogcaves/sunkencity/psydon{first_time_text = "Twilight Shores"; name = "Twilight Shores"})
"Ee" = (/obj/structure/spacevine,/turf/open/floor/fakespace,/area/rogue/under/cavewet/bogcaves/sunkencity/psydon{first_time_text = "Twilight Shores"; name = "Twilight Shores"})
"EY" = (/obj/effect/landmark/underworldsafe,/obj/structure/spacevine,/turf/open/water/cleanshallow,/area/rogue/under/cavewet/bogcaves/sunkencity/psydon{first_time_text = "Twilight Shores"; name = "Twilight Shores"})
"Fy" = (/obj/structure/portal,/turf/open/floor/rogue/blocks/stone,/area/rogue/under/cavewet/bogcaves/sunkencity/psydon{first_time_text = "Twilight Shores"; name = "Twilight Shores"})
"FE" = (/obj/structure/flora/roguetree/happyrandom{icon_state = "t8"; desc = "An old, beloved tree that even elves could love."},/turf/open/floor/grass,/area/rogue/under/cavewet/bogcaves/sunkencity/psydon{first_time_text = "Twilight Shores"; name = "Twilight Shores"})
"FV" = (/turf/closed/wall/mineral/rogue/wooddark/vertical,/area/rogue/under/cavewet/bogcaves/sunkencity/psydon{first_time_text = "Twilight Shores"; name = "Twilight Shores"})
"HD" = (/obj/effect/landmark/underworldcoin,/turf/open/water/cleanshallow,/area/rogue/under/cavewet/bogcaves/sunkencity/psydon{first_time_text = "Twilight Shores"; name = "Twilight Shores"})
"IQ" = (/obj/structure/table/wood{icon_state = "tablewood1"; dir = 1},/turf/open/floor/rogue/ruinedwood/spiral,/area/rogue/under/cavewet/bogcaves/sunkencity/psydon{first_time_text = "Twilight Shores"; name = "Twilight Shores"})
"JD" = (/obj/structure/spacevine,/turf/open/floor/grass,/area/rogue/under/cavewet/bogcaves/sunkencity/psydon{first_time_text = "Twilight Shores"; name = "Twilight Shores"})
"JZ" = (/turf/closed/wall/mineral/rogue/decostone/mossy/cand,/area/rogue/under/cavewet/bogcaves/sunkencity/psydon{first_time_text = "Twilight Shores"; name = "Twilight Shores"})
"Ks" = (/obj/structure/spacevine,/turf/open/water/cleanshallow,/area/rogue/under/cavewet/bogcaves/sunkencity/psydon{first_time_text = "Twilight Shores"; name = "Twilight Shores"})
"KH" = (/obj/structure/flora/ausbushes/ppflowers,/turf/open/floor/grass,/area/rogue/under/cavewet/bogcaves/sunkencity/psydon{first_time_text = "Twilight Shores"; name = "Twilight Shores"})
"KQ" = (/turf/open/floor/rogue/blocks/stone/stonepattern3,/area/rogue/under/cavewet/bogcaves/sunkencity/psydon{first_time_text = "Twilight Shores"; name = "Twilight Shores"})
"Lb" = (/turf/open/floor/rogue/cobblerock,/area/rogue/under/cavewet/bogcaves/sunkencity/psydon{first_time_text = "Twilight Shores"; name = "Twilight Shores"})
"Ln" = (/obj/structure/flora/grass/jungle/b,/turf/open/floor/rogue/blocks/stone,/area/rogue/under/cavewet/bogcaves/sunkencity/psydon{first_time_text = "Twilight Shores"; name = "Twilight Shores"})
"MU" = (/obj/structure/flora/roguetree/happyrandom{icon_state = "t12"; desc = "An old, beloved tree that even elves could love."},/turf/open/floor/grass,/area/rogue/under/cavewet/bogcaves/sunkencity/psydon{first_time_text = "Twilight Shores"; name = "Twilight Shores"})
"Np" = (/turf/open/floor/rogue/blocks/stone,/area/rogue/under/cavewet/bogcaves/sunkencity/psydon{first_time_text = "Twilight Shores"; name = "Twilight Shores"})
"Nt" = (/obj/machinery/light/rogue/wallfire/candle/blue/r,/turf/open/floor/rogue/ruinedwood/spiral,/area/rogue/under/cavewet/bogcaves/sunkencity/psydon{first_time_text = "Twilight Shores"; name = "Twilight Shores"})
"Pb" = (/obj/structure/flora/grass/jungle,/turf/open/water/cleanshallow,/area/rogue/under/cavewet/bogcaves/sunkencity/psydon{first_time_text = "Twilight Shores"; name = "Twilight Shores"})
"PP" = (/obj/structure/underworld/barrier,/turf/open/floor/grass,/area/rogue/under/cavewet/bogcaves/sunkencity/psydon{first_time_text = "Twilight Shores"; name = "Twilight Shores"})
"Rc" = (/turf/open/floor/grass,/area/rogue/under/cavewet/bogcaves/sunkencity/psydon{first_time_text = "Twilight Shores"; name = "Twilight Shores"})
"RT" = (/obj/structure/flora/roguetree/burnt,/turf/open/floor/grass,/area/rogue/under/cavewet/bogcaves/sunkencity/psydon{first_time_text = "Twilight Shores"; name = "Twilight Shores"})
"Sw" = (/turf/open/floor/rogue/dirt,/area/rogue/under/cavewet/bogcaves/sunkencity/psydon{first_time_text = "Twilight Shores"; name = "Twilight Shores"})
"SQ" = (/obj/structure/flora/grass/jungle/b,/obj/effect/wisp,/turf/open/floor/grass,/area/rogue/under/cavewet/bogcaves/sunkencity/psydon{first_time_text = "Twilight Shores"; name = "Twilight Shores"})
"Tb" = (/obj/structure/flora/junglebush/b,/turf/open/floor/grass,/area/rogue/under/cavewet/bogcaves/sunkencity/psydon{first_time_text = "Twilight Shores"; name = "Twilight Shores"})
"TV" = (/obj/effect/wisp,/obj/structure/chair/bench,/turf/open/floor/grass,/area/rogue/under/cavewet/bogcaves/sunkencity/psydon{first_time_text = "Twilight Shores"; name = "Twilight Shores"})
"Uy" = (/obj/structure/flora/roguetree/happyrandom,/turf/open/floor/grass,/area/rogue/under/cavewet/bogcaves/sunkencity/psydon{first_time_text = "Twilight Shores"; name = "Twilight Shores"})
"UP" = (/obj/effect/landmark/underworldsafe,/turf/open/floor/rogue/cobblerock,/area/rogue/under/cavewet/bogcaves/sunkencity/psydon{first_time_text = "Twilight Shores"; name = "Twilight Shores"})
"VR" = (/obj/structure/flora/grass/jungle{icon_state = "grassa2"},/turf/open/floor/grass,/area/rogue/under/cavewet/bogcaves/sunkencity/psydon{first_time_text = "Twilight Shores"; name = "Twilight Shores"})
"Wa" = (/turf/open/floor/rogue/ruinedwood/spiral,/area/rogue/under/cavewet/bogcaves/sunkencity/psydon{first_time_text = "Twilight Shores"; name = "Twilight Shores"})
"Yt" = (/obj/structure/chair/bench{dir = 8},/turf/open/floor/grass,/area/rogue/under/cavewet/bogcaves/sunkencity/psydon{first_time_text = "Twilight Shores"; name = "Twilight Shores"})
"YT" = (/obj/structure/flora/grass/jungle/b,/turf/open/floor/rogue/cobblerock,/area/rogue/under/cavewet/bogcaves/sunkencity/psydon{first_time_text = "Twilight Shores"; name = "Twilight Shores"})

(1,1,1) = {"
gDgDgDgDiNiNiNiNiNiNiNiNiNiNgDgDgDiNgDgDgDgDgDgDgDgDdPiNiNiNiNiNgDgDgDgDgDgDgDiNiNKsKsiNiNKsiNiNiNgD
gDgDiNiNiNiNiNiNdPiNiNdPAAAAAAAAagagagagagagagagagagAAAAAAAAdPiNiNgDgDgDgDiNiNiNiNiNiNKsKsKsKsKsiNgD
gDiNiNiNftKsiNiNiNiNiNAAiNiNiNiNiNdPgDgDgDiNiNdPiNiNiNiNiNiNAAiNiNgDgDiNiNiNiNiNiNiNiNiNiNiNdPiNgDgD
gDiNiNiNftwpKsiNiNiNiNAAdPiNiNdPiNiNiNiNiNiNiNiNiNdPiNdPiNiNAAiNiNiNiNiNiNiNftiNiNiNiNiNiNiNiNgDgDgD
iNiNiNiNiNftKsiNiNdPiNAAiNiNiNiNiNiNiNDHDHDHDHDHiNiNiNiNiNdPAAiNiNiNiNiNdPiNftftndndftftiNiNiNiNgDgD
iNiNdPiNgDftiNiNiNiNiNAAiNiNiNiNiNiNiNDHhZbnDHiNiNkjiNKsKsiNAAiNiNiNiNiNiNiNiNKsKsftftftftiNiNiNiNgD
iNiNiNgDgDiNiNdPiNiNiNqKRcRcRciNiNkjiNiNLbKQiNiNiNiNiNJDRcRcEYKsiNiNiNiNiNiNiNiNiNKsftndndftftftiNiN
iNKsKsiNgDgDiNiNiNiNiNAWAWAWRcAWAWAWUyRcLbLbRcRcRcAWAWJDAWAWxaRcRcRcSwSwSwiNiNiNiNiNiNftftKsiNiNKsiN
iNiNKswpiNiNiNSwSwRcUyJDAWRcasRcxZdxpNRcKQLbRcpNUyJDRcRcAWAWJDRcRcUyRcRcRcSwaYaYRTuEtdtdkPiNiNKsKsiN
gDiNftftKsiNiNSwSwRcRcJDAWRcRcdxzaVRdxRcKQLbPPRcRcKHRcUyAWAWJDUydxRcRcRcRcuERcRcRcRcRcRcSwiNiNKsKsiN
gDgDiNftwpiNiNSwUyRcRcRcAWRcRchXVRVRRcRcLbLbyNRcRcuERcRcAWRcRcRcSQdxRcRcRcAEAEAEAERcRcRcSwiNiNiNKsgD
gDiNiNiNwpKsSwSwJDRcUyRcAWUyRcRcRczadxKQLbLbRcRcRcRcAWRcAWRcRcRcRcdxRcUyAEbCbCbCbCAERcRcSwiNiNiNiNgD
iNiNKswpiNiNSwRcRcJDRcRcAWAWAWRcRcRcdxLbLbKQRcRcRciNAWRcRcUyRcUyRcRcbCbCbCbCbCbCbCbCbCUyaYaYiNiNgDgD
iNiNiNwpftiNSwuERcJDJDUyRcJDAWRTiNiNRcLbKQdxRcRciNiNAWUyRcRcRTRcRcRcbCAEAEFyNpKQKQbCbCbCRctdftftiNgD
iNiNiNKsKsiNSwRcRcRcJDJDRcJDAWRcRciNRcLbYTdxdxRciNRTAWRcRcRcRcuERcRcbCAEstKQKQKQfapDNpAERcSwiNftiNiN
iNgDiNiNiNiNSwRcAWRcRcRcRcRcAWAWRTRcpNLbLbpNAWRcAWAWAWdxdxUyRcRcRcUybCfaKQKQKQKQNpfaNpAERcSwiNiNftiN
iNgDgDiNiNSwSwAWRcRcRcRcUyRcAWAWAWRcRcLbLbRcRcUyRcAWAWRcdxRcdxdxRcRcbCLnfaKQKQKQNpKQAEbCRcSwSwiNftiN
iNiNgDgDiNSwSwRcRcRcuERcRcRcJDAWAWUydxKQLbKQRcRcRTJDAWRcdxRcRcdxdxRcbCNpKQKQKQKQfafaAEbCUyuESwiNiNiN
iNiNgDgDiNSwSwRcRcRcRcRcRcRcRcAWRcRcdxfaLbLbRcRcRcRcAWUyuERcRcRcdxRcJZKQKQKQKQKQuEdxdxJZRcRcSwiNiNiN
dPiNiNgDiNSwkPRcRcRcRcRcRcRcRcAWRcdxRcKQjdLbdxRcRcRcRcRcRcRcRcRcRcRcRcKQKQNpNpRcRcRcdxdxRcRcaYiNKsiN
iNiNiNiNiNSwJDAWJDRcRcRcRcRcuEAWUyRcdxRcLbLbdxdxFERcUyRcRcdxRcRcRcRcRcRcdxdxRcRcRcRcRcRcdxpuSwiNKsiN
iNiNiNiNiNkPRcAWRcuERcRcRcRcRcRcqKqTdxdxLbLbRcdxdxRcqKRcRcRcdxdxRcRcRcRcRcdxqkRciNiNiNRcRcyrbLiNKsKs
iNiNiNiNiNkPAWAWAWRcRcRcRcRcRcRcqKRcRcRcKQLbRcRcKHRcqKRcRcRcRcdxRcRcRcdxdxqkPbdwdwiNiNRcRcRcbLdwKsKs
iNiNdPiNiNkPtdJDJDRcRcRcAWRcRcRcqKRcRcRcLbLbRcRcRcRcqKRcRcuERcRcRcRcRcTbdwPbyLiNdwiNiNRcRcRcSwdwdwiN
iNiNiNiNiNKsSwSwSwSwSwkPkPAWRcRcRcqKqKqHUPUPqHqKqKqKRcRcRcRcRcdxRcRcRciNiNyLyLiNiNiNfARcJDSwiNiNiNiN
iNiNiNiNftiNiNiNiNiNSwSwkPSwRcRTzadxRcdxLbKQRcRcRcRcRTRcJDRcRcdxSQRcRciNiNyLdwiNiNRcRcRcAWkPiNiNiNiN
iNiNKsftftKsiNiNiNiNiNSwSwJDRcdxzaVRdxRcYTLbKQRcRcRcRcRcJDJDUyAWdxRcRcRciNiNdwdxRcuERckPtdndiNiNiNiN
iNKsKsiNftiNiNiNiNiNiNSwRcRcRcdxVRVRdxRcKQLbLbYTdxRcRcRcRcJDiNAWJDJDUyRcRcRcRcRcRcRcRckPiNftiNiNdPiN
iNiNftftiNiNiNiNiNiNiNSwRcRcBZdxVRzazaKHRcKQLbLbYTpNMUJDasJDiNftftftkPzpRcRcdxRcRcaYSwiNftftiNiNiNiN
iNftiNiNiNgDiNdPiNiNRcRcRcRcRcyAVRVRzadxRcRcKQLbLbLbTVJDJDJDBZiNftiNKsiNSwSwbLbLaYSwiNiNftftKsKsKsiN
iNiNiNiNgDgDiNiNiNRcRcRcUyRcRcRcdxVRdxdxdxRcKQLbKQLbKQqkzaJDRcRciNftftKsKsiNiNiNiNiNiNKsiNftftftKsiN
iNiNiNiNgDgDiNiNiNRcBZRcuERcBZdxliwxliliuEKQqILbLbLbLbKQnpzaRcBZiNiNftftiNiNiNiNiNiNiNiNKsKsiNftKsiN
iNiNiNdPgDiNiNiNiNRcRcRcRcRcRcwxwcrriuliBnwxliLbLbLbLbzALbRczaqTRciNiNftftiNiNiNiNdPiNiNiNiNftftiNiN
iNKsiNiNiNiNiNiNiNBZRcRcBZRcRclinVWaWaIQCNrMliLbKQLbKQLbjhBZzaRcRciNiNiNiNiNiNiNiNiNiNiNiNiNiNiNiNiN
iNKsKsiNiNiNdPiNiNRcRcUyRcuERcFVWaIQIQIQCNWawxLbKQLbLbLbfaqkspRcRcSwiNiNdPiNiNiNiNiNiNiNiNiNiNiNiNgD
iNKsiNiNiNiNiNiNiNRcJDJDRcanRcwxWaCNCNCNWaWarULbLbLbLbLbpNVRdxRcUySwiNiNiNiNiNgDgDiNiNiNiNiNiNgDgDgD
iNiNiNiNiNiNiNiNiNBZRcJDRcRcJDFVWaWaWaWaWaWarULbLbLbLbKQRcRcdxdxRcRciNiNiNiNgDgDgDgDiNiNiNiNKsiNgDgD
iNiNiNiNiNiNiNiNiNRcRcJDJDBZJDlidsWaWaWaWaWawxKQLbLbKQYtBZRcRcRcRcBZiNiNiNiNiNiNgDgDgDiNdPiNKsiNgDgD
iNiNiNdPiNiNiNftftiNBZRcJDRcRcwxdAdOCNIQCNNtliLbLbKQLbpNRcRcuERcRcaYiNdPiNiNiNiNiNgDgDgDiNiNKsiNiNiN
iNiNiNiNiNiNiNftftftRcRcUyRcuERcliwxBnwxBnwxliLbYTKQRcRcRcuERcRcSwiNiNiNiNiNiNiNiNgDgDgDiNiNKsKsiNiN
iNKsiNiNiNiNiNftndiNiNBZRcRcRcRcRcJDJDKHSQRcpNLbfadxRcRcRcRcRcRcSwiNiNiNgDiNiNiNdPgDgDiNiNiNiNKsiNgD
iNKsiNiNiNiNiNndndiNiNSwaYRcRcRcRcRcJDRcRcdxRcLbRcRcRcRcRcRcRckOiNdPiNiNgDiNiNiNiNgDgDftiNiNiNiNiNgD
KsKsiNiNiNiNftftftiNiNSwSwBZRcRcRcRcRcRcRcRcRcKQRcRcRcRcRcBZaYiNiNiNiNgDgDftftiNiNiNiNftiNiNiNiNgDgD
iNKsKsiNftftndftiNiNiNiNiNSwaYRcgBRcRcRcRcgBRcRcRcRcRcRcqTSwSwiNiNiNiNiNgDgDftiNKsiNiNftftftftiNiNiN
iNKsiNftndftftiNiNiNiNiNiNiNSwSwSwRcSwSwRcRcSwSwzpRcRcSwBtSwiNjCiNiNKsiNgDiNftiNKsKsKsiNiNftndftiNiN
iNiNiNftftiNiNiNiNiNiNiNjCiNiNiNSwSwiNiNSwSwiNiNiNSwSwiNiNiNiNiNiNKsKsiNndftiNiNiNiNKsKsiNiNftftftft
iNiNiNiNiNiNKsiNiNiNdPiNiNHDiNiNiNiNiNHDiNiNiNiNHDiNiNiNiNiNiNHDiNKsiNftndiNiNiNiNiNiNKsiNiNftftiNiN
gDiNiNiNiNiNKsKsiNiNiNiNiNiNiNiNHDiNiNiNiNiNiNiNiNiNiNHDiNiNiNiNiNiNftftftiNiNiNiNdPiNiNiNiNiNftiNgD
gDgDiNiNdPiNgDKsEegDjCiNgDgDgDiNiNgDgDAtiNiNgDgDiNjCiNgDgDgDjCiNiNftgDgDftftiNiNiNiNiNiNiNgDiNiNgDgD
gDgDgDiNiNgDgDgDgDgDgDgDgDgDgDgDgDgDgDgDgDgDgDgDgDgDgDgDgDgDgDgDiNgDgDgDgDiNiNiNiNiNiNgDgDgDgDgDgDgD
"}
