"aa" = (/obj/structure/mineral_door/secret/rogue,/turf/open/floor/rogue/blocks/newstone,/area/rogue/outdoors/exposed/under/sewer)
"as" = (/obj/structure/spider/stickyweb,/obj/effect/decal/dirt{dir = 4},/turf/open/water/sewer,/area/rogue/outdoors/exposed/under/sewer)
"az" = (/obj/effect/decal/border/ruinedwood{dir = 8},/obj/effect/decal/wood/ruinedwood{dir = 4},/obj/effect/decal/cleanable/dirt/dust,/turf/open/floor/rogue/greenstone,/area/rogue/outdoors/exposed/under/sewer)
"aL" = (/turf/closed/mineral/rogue,/area/rogue/outdoors/exposed/under/sewer)
"aV" = (/obj/effect/decal/cobbleedge{dir = 6; pixel_x = 25; pixel_y = -13},/turf/open/floor/rogue/cobble,/area/rogue/outdoors/exposed/under/sewer)
"bv" = (/obj/structure/rack/rogue/shelf/big,/obj/item/rogue/instrument/accord,/turf/open/floor/rogue/cobble,/area/rogue/outdoors/exposed/under/sewer)
"by" = (/obj/structure/table/wood/crafted,/obj/item/reagent_containers/glass/cup/wooden,/obj/effect/decal/cleanable/dirt/dust,/turf/open/floor/rogue/cobble,/area/rogue/outdoors/exposed/under/sewer)
"bH" = (/obj/structure/spider/stickyweb,/obj/effect/decal/cobbleedge{dir = 7},/turf/open/floor/rogue/dirt,/area/rogue/outdoors/exposed/under/sewer)
"cb" = (/obj/effect/decal/wood/ruinedwood/turned{dir = 3},/obj/effect/decal/wood/ruinedwood/turned{dir = 8},/obj/effect/decal/cobbleedge{dir = 10},/obj/effect/decal/wood/ruinedwood/turned{dir = 1},/turf/open/floor/rogue/dirt,/area/rogue/outdoors/exposed/under/sewer)
"cy" = (/obj/structure/table/wood/crafted,/obj/item/reagent_containers/glass/cup/wooden,/obj/item/reagent_containers/glass/cup/silver,/turf/open/floor/rogue/cobble,/area/rogue/outdoors/exposed/under/sewer)
"dv" = (/obj/structure/bars/tough,/obj/effect/decal/dirt{dir = 4},/turf/open/water/sewer,/area/rogue/outdoors/exposed/under/sewer)
"dQ" = (/obj/effect/decal/wood/ruinedwood{dir = 8},/turf/open/floor/rogue/woodturned/nosmooth,/area/rogue/outdoors/exposed/under/sewer)
"ew" = (/obj/effect/decal/cobbleedge{dir = 6},/turf/open/floor/rogue/dirt,/area/rogue/outdoors/exposed/under/sewer)
"eX" = (/obj/structure/fluff/railing/border,/obj/effect/decal/dirt{dir = 8},/obj/effect/decal/dirt{dir = 3},/turf/open/water/sewer,/area/rogue/outdoors/exposed/under/sewer)
"fj" = (/obj/effect/decal/wood/ruinedwood{dir = 6},/obj/effect/decal/dirt{dir = 8},/turf/open/floor/rogue/dirt,/area/rogue/outdoors/exposed/under/sewer)
"gs" = (/obj/effect/decal/cleanable/dirt/dust,/obj/effect/decal/cobbleedge{dir = 4},/turf/open/floor/rogue/dirt,/area/rogue/outdoors/exposed/under/sewer)
"gL" = (/obj/effect/decal/cobbleedge{dir = 10},/obj/effect/decal/cobbleedge{dir = 5; pixel_x = -5},/turf/open/floor/rogue/dirt,/area/rogue/outdoors/exposed/under/sewer)
"gS" = (/obj/effect/decal/cobbleedge{icon_state = "borderfall"; dir = 1},/obj/effect/decal/dirt{dir = 4},/obj/effect/decal/dirt{dir = 1; pixel_y = -14},/turf/open/water/sewer,/area/rogue/outdoors/exposed/under/sewer)
"hv" = (/obj/structure/fluff/railing/border,/obj/effect/decal/dirt{dir = 3},/turf/open/floor/rogue/wood/nosmooth,/area/rogue/outdoors/exposed/under/sewer)
"hF" = (/mob/living/carbon/human/species/skeleton/npc,/obj/effect/decal/cleanable/dirt/dust,/turf/open/floor/rogue/cobble,/area/rogue/outdoors/exposed/under/sewer)
"hL" = (/turf/open/floor/rogue/woodturned/nosmooth,/area/rogue/outdoors/exposed/under/sewer)
"is" = (/obj/structure/glowshroom,/obj/effect/decal/dirt{dir = 8},/turf/open/water/sewer,/area/rogue/outdoors/exposed/under/sewer)
"iJ" = (/turf/open/floor/rogue/wood/nosmooth,/area/rogue/outdoors/exposed/under/sewer)
"jf" = (/obj/structure/spider/stickyweb,/obj/effect/decal/cobbleedge{dir = 6},/turf/open/floor/rogue/greenstone,/area/rogue/outdoors/exposed/under/sewer)
"jF" = (/obj/structure/fluff/railing/border,/obj/effect/decal/border/ruinedwood{dir = 8},/obj/effect/decal/wood/ruinedwood{dir = 4},/obj/effect/decal/cleanable/dirt/dust,/turf/open/floor/rogue/greenstone,/area/rogue/outdoors/exposed/under/sewer)
"jT" = (/obj/structure/chair/wood/rogue,/turf/open/floor/rogue/cobble,/area/rogue/outdoors/exposed/under/sewer)
"lb" = (/obj/effect/decal/border/ruinedwood{dir = 4},/obj/effect/decal/cobbleedge{dir = 5},/obj/effect/decal/cleanable/dirt/dust,/turf/open/floor/rogue/greenstone,/area/rogue/outdoors/exposed/under/sewer)
"lT" = (/obj/structure/mineral_door/wood/red,/obj/structure/spider/stickyweb,/turf/open/floor/rogue/blocks/newstone,/area/rogue/outdoors/exposed/under/sewer)
"mk" = (/obj/effect/decal/remains/human,/turf/open/floor/rogue/cobble,/area/rogue/outdoors/exposed/under/sewer)
"mU" = (/turf/open/floor/rogue/cobble,/area/rogue/outdoors/exposed/under/sewer)
"nf" = (/obj/effect/holodeck_effect/cards,/turf/open/floor/rogue/wood/nosmooth,/area/rogue/outdoors/exposed/under/sewer)
"oc" = (/obj/structure/fluff/railing/border,/obj/structure/fermenting_barrel/beer,/obj/effect/decal/border/ruinedwood{dir = 4},/obj/effect/decal/cleanable/dirt/dust,/turf/open/floor/rogue/greenstone,/area/rogue/outdoors/exposed/under/sewer)
"oI" = (/obj/effect/decal/wood/ruinedwood/turned{dir = 9},/obj/effect/decal/cobbleedge{dir = 9},/obj/effect/decal/wood/ruinedwood/turned{dir = 4},/obj/effect/decal/wood/ruinedwood/turned{dir = 7},/turf/open/floor/rogue/dirt,/area/rogue/outdoors/exposed/under/sewer)
"oW" = (/obj/effect/decal/wood/ruinedwood{dir = 1},/obj/structure/fluff/railing/border{dir = 1},/obj/effect/decal/cobbleedge{icon_state = "borderfall"; dir = 1},/turf/open/floor/rogue/cobble,/area/rogue/outdoors/exposed/under/sewer)
"oZ" = (/obj/structure/spider/stickyweb,/obj/effect/decal/dirt{dir = 8},/turf/open/water/sewer,/area/rogue/outdoors/exposed/under/sewer)
"pf" = (/obj/effect/decal/border/ruinedwood{dir = 8},/obj/effect/decal/wood/ruinedwood/turned{dir = 1},/obj/effect/decal/wood/ruinedwood/turned{dir = 6},/obj/effect/decal/cleanable/dirt/dust,/turf/open/floor/rogue/greenstone,/area/rogue/outdoors/exposed/under/sewer)
"ps" = (/obj/structure/table/wood/crafted,/obj/item/reagent_containers/glass/bottle/rogue/wine,/obj/item/reagent_containers/glass/bottle/rogue/wine,/obj/item/reagent_containers/glass/bottle/rogue/wine,/turf/open/floor/rogue/cobble,/area/rogue/outdoors/exposed/under/sewer)
"pB" = (/obj/structure/glowshroom,/obj/effect/decal/border/ruinedwood{dir = 8},/obj/effect/decal/wood/ruinedwood/turned{dir = 4},/obj/effect/decal/cleanable/dirt/dust,/turf/open/floor/rogue/greenstone,/area/rogue/outdoors/exposed/under/sewer)
"pG" = (/obj/effect/decal/dirt{dir = 4},/turf/open/water/sewer,/area/rogue/outdoors/exposed/under/sewer)
"qs" = (/obj/machinery/light/rogue/torchholder/r,/obj/effect/decal/wood/ruinedwood{dir = 9},/obj/effect/decal/cobbleedge{dir = 9},/obj/effect/decal/dirt{dir = 4},/obj/effect/decal/dirt{dir = 3},/turf/open/floor/rogue/dirt,/area/rogue/outdoors/exposed/under/sewer)
"qw" = (/obj/effect/decal/wood/ruinedwood{dir = 4},/obj/structure/fluff/railing/border{dir = 4},/obj/effect/decal/cleanable/dirt/dust,/turf/open/floor/rogue/cobble,/area/rogue/outdoors/exposed/under/sewer)
"qz" = (/obj/effect/decal/wood/ruinedwood,/turf/open/floor/rogue/dirt,/area/rogue/outdoors/exposed/under/sewer)
"qE" = (/obj/structure/fluff/grindwheel,/obj/effect/decal/cleanable/dirt/dust,/turf/open/floor/rogue/woodturned/nosmooth,/area/rogue/outdoors/exposed/under/sewer)
"qM" = (/mob/living/carbon/human/species/skeleton/npc,/obj/effect/decal/cleanable/dirt/dust,/obj/effect/decal/cobbleedge{dir = 8},/turf/open/floor/rogue/dirt,/area/rogue/outdoors/exposed/under/sewer)
"rb" = (/obj/effect/decal/border/ruinedwood{dir = 4},/obj/effect/decal/cleanable/dirt/dust,/turf/open/floor/rogue/greenstone,/area/rogue/outdoors/exposed/under/sewer)
"rZ" = (/obj/item/reagent_containers/glass/cup/steel,/obj/structure/table/wood/crafted,/turf/open/floor/rogue/woodturned/nosmooth,/area/rogue/outdoors/exposed/under/sewer)
"sL" = (/obj/item/reagent_containers/glass/cup/skull,/obj/structure/table/wood/crafted,/obj/effect/decal/cleanable/dirt/dust,/turf/open/floor/rogue/woodturned/nosmooth,/area/rogue/outdoors/exposed/under/sewer)
"td" = (/obj/effect/decal/remains/human,/turf/open/floor/rogue/greenstone,/area/rogue/outdoors/exposed/under/sewer)
"tJ" = (/obj/effect/decal/wood/ruinedwood{dir = 5},/obj/structure/fluff/railing/border{dir = 5},/obj/effect/decal/cobbleedge{icon_state = "borderfall"; dir = 1},/obj/effect/decal/cobbleedge{dir = 4},/turf/open/floor/rogue/cobble,/area/rogue/outdoors/exposed/under/sewer)
"uA" = (/obj/effect/decal/border/ruinedwood/inverted{dir = 8},/obj/item/roguebin/water,/obj/effect/decal/wood/ruinedwood/turned{dir = 5},/turf/open/floor/rogue/cobble,/area/rogue/outdoors/exposed/under/sewer)
"uO" = (/obj/item/roguemachine/merchant,/turf/open/floor/rogue/wood/nosmooth,/area/rogue/outdoors/exposed/under/sewer)
"vJ" = (/obj/structure/glowshroom,/turf/open/floor/rogue/greenstone,/area/rogue/outdoors/exposed/under/sewer)
"vR" = (/obj/machinery/light/rogue/hearth,/obj/item/cooking/pan,/turf/open/floor/rogue/cobble,/area/rogue/outdoors/exposed/under/sewer)
"wa" = (/obj/structure/chair/wood/rogue{dir = 4},/turf/open/floor/rogue/cobble,/area/rogue/outdoors/exposed/under/sewer)
"xP" = (/obj/effect/decal/border/ruinedwood{dir = 4},/obj/effect/decal/cobbleedge{dir = 6},/obj/effect/decal/cleanable/dirt/dust,/obj/effect/decal/cleanable/dirt/dust,/turf/open/floor/rogue/greenstone,/area/rogue/outdoors/exposed/under/sewer)
"yx" = (/obj/structure/fermenting_barrel/beer,/obj/effect/decal/border/ruinedwood{dir = 8},/obj/effect/decal/wood/ruinedwood{dir = 4},/obj/effect/decal/cleanable/dirt/dust,/turf/open/floor/rogue/greenstone,/area/rogue/outdoors/exposed/under/sewer)
"yV" = (/obj/structure/glowshroom,/obj/effect/decal/dirt{dir = 4},/turf/open/water/sewer,/area/rogue/outdoors/exposed/under/sewer)
"yY" = (/obj/structure/fluff/railing/border,/obj/effect/decal/dirt{dir = 4},/obj/effect/decal/dirt{dir = 3},/turf/open/water/sewer,/area/rogue/outdoors/exposed/under/sewer)
"Aq" = (/mob/living/carbon/human/species/skeleton/npc,/turf/open/floor/rogue/cobble,/area/rogue/outdoors/exposed/under/sewer)
"BW" = (/obj/effect/decal/wood/ruinedwood{dir = 8},/obj/structure/fluff/nest,/obj/effect/decal/dirt{dir = 4},/turf/open/floor/rogue/dirt,/area/rogue/outdoors/exposed/under/sewer)
"Cj" = (/obj/effect/decal/wood/ruinedwood{dir = 4},/obj/structure/fluff/nest,/obj/effect/decal/dirt{dir = 8},/turf/open/floor/rogue/dirt,/area/rogue/outdoors/exposed/under/sewer)
"CZ" = (/obj/effect/decal/wood/ruinedwood{dir = 10},/obj/effect/decal/cobbleedge{dir = 10},/obj/effect/decal/dirt{dir = 4},/turf/open/floor/rogue/dirt,/area/rogue/outdoors/exposed/under/sewer)
"DB" = (/obj/effect/decal/cleanable/dirt/dust,/turf/open/floor/rogue/cobble,/area/rogue/outdoors/exposed/under/sewer)
"DG" = (/obj/effect/decal/cobbleedge{dir = 5},/obj/effect/decal/cobbleedge{dir = 10; pixel_x = 6; pixel_y = 8},/turf/open/floor/rogue/dirt,/area/rogue/outdoors/exposed/under/sewer)
"Er" = (/obj/item/chair/stool/bar/rogue,/turf/open/floor/rogue/woodturned/nosmooth,/area/rogue/outdoors/exposed/under/sewer)
"Es" = (/obj/structure/glowshroom,/obj/effect/decal/cobbleedge{dir = 10},/turf/open/floor/rogue/greenstone,/area/rogue/outdoors/exposed/under/sewer)
"EJ" = (/obj/effect/decal/cobbleedge{dir = 9; pixel_x = -28; pixel_y = 20},/turf/open/floor/rogue/cobble,/area/rogue/outdoors/exposed/under/sewer)
"Fj" = (/obj/effect/decal/border/ruinedwood{dir = 8},/obj/effect/decal/wood/ruinedwood{dir = 5},/obj/structure/fluff/dryingrack,/obj/effect/decal/cleanable/dirt/dust,/turf/open/floor/rogue/greenstone,/area/rogue/outdoors/exposed/under/sewer)
"Gx" = (/obj/structure/closet/dirthole/closed/loot,/turf/open/floor/rogue/dirt,/area/rogue/outdoors/exposed/under/sewer)
"GG" = (/turf/open/floor/rogue/dirt,/area/rogue/outdoors/exposed/under/sewer)
"Hl" = (/obj/structure/table/wood/crafted,/obj/item/reagent_containers/glass/cup/wooden,/obj/item/dice/d6,/obj/effect/decal/cobbleedge{icon_state = "borderfall"; dir = 1},/obj/effect/decal/cleanable/dirt/dust,/turf/open/floor/rogue/cobble,/area/rogue/outdoors/exposed/under/sewer)
"IH" = (/obj/structure/fermenting_barrel/water,/turf/open/floor/rogue/cobble,/area/rogue/outdoors/exposed/under/sewer)
"Jd" = (/obj/structure/spider/stickyweb,/turf/open/floor/rogue/greenstone,/area/rogue/outdoors/exposed/under/sewer)
"JH" = (/obj/structure/rack/rogue/shelf/big,/obj/item/rogue/instrument/lute,/obj/effect/decal/cleanable/dirt/dust,/turf/open/floor/rogue/cobble,/area/rogue/outdoors/exposed/under/sewer)
"KA" = (/obj/effect/decal/cobbleedge{icon_state = "borderfall"; dir = 1},/obj/effect/decal/dirt{dir = 8},/obj/effect/decal/dirt{dir = 1; pixel_y = -14},/turf/open/water/sewer,/area/rogue/outdoors/exposed/under/sewer)
"Lc" = (/obj/effect/decal/cobbleedge{dir = 10},/obj/effect/decal/wood/ruinedwood/turned{dir = 1},/obj/effect/decal/cobbleedge{dir = 5},/obj/effect/decal/wood/ruinedwood/turned{dir = 3},/obj/effect/decal/wood/ruinedwood/turned{dir = 8},/obj/effect/decal/wood/ruinedwood/turned{dir = 4},/turf/open/floor/rogue/dirt,/area/rogue/outdoors/exposed/under/sewer)
"Ld" = (/obj/structure/closet/crate/chest/lootbox,/obj/effect/decal/cobbleedge{dir = 1},/turf/open/floor/rogue/dirt,/area/rogue/outdoors/exposed/under/sewer)
"Lf" = (/obj/structure/rack/rogue/shelf/big,/turf/open/floor/rogue/cobble,/area/rogue/outdoors/exposed/under/sewer)
"Ln" = (/obj/effect/decal/wood/ruinedwood{dir = 1},/obj/effect/decal/dirt{dir = 3},/turf/open/floor/rogue/dirt,/area/rogue/outdoors/exposed/under/sewer)
"Mm" = (/obj/effect/decal/wood/ruinedwood{dir = 8},/obj/structure/fluff/railing/border{icon_state = "border"; dir = 8},/turf/open/floor/rogue/cobble,/area/rogue/outdoors/exposed/under/sewer)
"MJ" = (/obj/effect/decal/cobbleedge{dir = 10},/obj/effect/decal/wood/ruinedwood{dir = 8},/obj/effect/decal/wood/ruinedwood/turned{dir = 1},/obj/effect/decal/wood/ruinedwood/turned{dir = 4},/turf/open/floor/rogue/dirt,/area/rogue/outdoors/exposed/under/sewer)
"Nl" = (/obj/machinery/light/rogue/torchholder,/turf/closed/wall/mineral/rogue/stonebrick,/area/rogue/outdoors/exposed/under/sewer)
"NR" = (/obj/effect/decal/cobbleedge{dir = 5},/obj/effect/decal/cobbleedge{dir = 10},/turf/open/floor/rogue/dirt,/area/rogue/outdoors/exposed/under/sewer)
"Os" = (/obj/effect/decal/wood/ruinedwood{dir = 4},/turf/open/floor/rogue/cobble,/area/rogue/outdoors/exposed/under/sewer)
"OQ" = (/obj/effect/decal/border/ruinedwood{dir = 8},/obj/effect/decal/wood/ruinedwood{dir = 6},/obj/effect/decal/cleanable/dirt/dust,/turf/open/floor/rogue/greenstone,/area/rogue/outdoors/exposed/under/sewer)
"Qi" = (/obj/structure/chair/wood/rogue{dir = 1},/obj/effect/decal/wood/ruinedwood{dir = 9},/obj/structure/fluff/railing/border{dir = 9},/obj/effect/decal/cobbleedge{icon_state = "borderfall"; dir = 1},/obj/effect/decal/cobbleedge{dir = 8},/turf/open/floor/rogue/cobble,/area/rogue/outdoors/exposed/under/sewer)
"QN" = (/obj/structure/closet/crate/chest{opened = 1},/obj/item/reagent_containers/powder/flour,/obj/item/reagent_containers/powder/flour,/obj/item/reagent_containers/powder/flour,/obj/item/reagent_containers/food/snacks/rogue/foodbase/hardtack_raw,/obj/item/reagent_containers/food/snacks/rogue/foodbase/hardtack_raw,/obj/item/reagent_containers/food/snacks/rogue/foodbase/hardtack_raw,/turf/open/floor/rogue/cobble,/area/rogue/outdoors/exposed/under/sewer)
"Rb" = (/obj/effect/decal/wood/ruinedwood{dir = 5},/obj/effect/decal/cobbleedge{dir = 5},/obj/effect/decal/dirt{dir = 4},/obj/effect/decal/dirt{dir = 3},/turf/open/floor/rogue/dirt,/area/rogue/outdoors/exposed/under/sewer)
"Rs" = (/obj/effect/decal/dirt{dir = 8},/turf/open/water/sewer,/area/rogue/outdoors/exposed/under/sewer)
"RT" = (/obj/item/roguecoin/silver/pile,/turf/open/floor/rogue/wood/nosmooth,/area/rogue/outdoors/exposed/under/sewer)
"Sc" = (/obj/effect/decal/cobbleedge{dir = 9},/turf/open/floor/rogue/dirt,/area/rogue/outdoors/exposed/under/sewer)
"SG" = (/obj/effect/decal/cleanable/dirt/dust,/turf/open/floor/rogue/woodturned/nosmooth,/area/rogue/outdoors/exposed/under/sewer)
"Ta" = (/obj/structure/table/wood/crafted,/turf/open/floor/rogue/woodturned/nosmooth,/area/rogue/outdoors/exposed/under/sewer)
"Tq" = (/obj/effect/decal/cobbleedge{dir = 8},/turf/open/floor/rogue/dirt,/area/rogue/outdoors/exposed/under/sewer)
"TJ" = (/obj/effect/decal/cobbleedge,/turf/open/floor/rogue/dirt,/area/rogue/outdoors/exposed/under/sewer)
"TY" = (/obj/structure/spider/stickyweb,/turf/open/floor/rogue/cobble,/area/rogue/outdoors/exposed/under/sewer)
"Ua" = (/obj/structure/bars/tough,/obj/effect/decal/dirt{dir = 8},/turf/open/water/sewer,/area/rogue/outdoors/exposed/under/sewer)
"Vq" = (/obj/effect/decal/wood/ruinedwood{dir = 8},/obj/effect/decal/dirt{dir = 4},/obj/structure/fluff/nest,/turf/open/floor/rogue/dirt,/area/rogue/outdoors/exposed/under/sewer)
"WH" = (/obj/structure/mineral_door/wood/red,/turf/open/floor/rogue/blocks/newstone,/area/rogue/outdoors/exposed/under/sewer)
"Yc" = (/obj/structure/bars/tough,/turf/open/floor/rogue/greenstone,/area/rogue/outdoors/exposed/under/sewer)
"Yo" = (/obj/structure/rack/rogue/shelf/big,/obj/effect/decal/cleanable/dirt/dust,/obj/effect/decal/cobbleedge{dir = 10; pixel_x = -19; pixel_y = -33},/turf/open/floor/rogue/cobble,/area/rogue/outdoors/exposed/under/sewer)
"YG" = (/obj/machinery/light/rogue/oven/west,/turf/open/floor/rogue/cobble,/area/rogue/outdoors/exposed/under/sewer)
"Zb" = (/obj/structure/chair/wood/rogue{dir = 1},/turf/open/floor/rogue/cobble,/area/rogue/outdoors/exposed/under/sewer)
"Zg" = (/turf/closed/wall/mineral/rogue/stonebrick,/area/rogue/outdoors/exposed/under/sewer)
"Zw" = (/obj/machinery/light/rogue/lanternpost,/obj/effect/decal/border/ruinedwood{dir = 4},/obj/effect/decal/cleanable/dirt/dust,/turf/open/floor/rogue/greenstone,/area/rogue/outdoors/exposed/under/sewer)
"ZT" = (/obj/effect/decal/cobbleedge{icon_state = "borderfall"; dir = 1},/turf/closed/wall/mineral/rogue/stonebrick,/area/rogue/outdoors/exposed/under/sewer)

(1,1,1) = {"
ZgZgZgZgZgZgZgZgZgZgZgZgZgZg
ZgaLaLaLaLZgmUTYTYewGxZgaLZg
ZgaLaLaLaLZgmUZgZgZgScZgaLZg
ZgZgZgZgZgZgTYZgaLZgmUZgaLZg
ZgmUTYTYmUmUmkZgaLZgTYZgZgZg
WHmUZgZgZgaaZgZgZgZgmUTYTYWH
ZgZgNlJHbvxPRsyVyxZTZglTZgZg
ZgqwuOMmmUrbRspGyxZTLfbHYoZg
ZgtJoWQiDBrbRspGFjZTgsGGqMZg
ZgmUwaHlDBrbispGOQZghFLdAqZg
ZgNRTJmUmUrbRsyVazNlZgZgZgZg
ZgjTDGTqmUoceXyYjFSGqEhLuAZg
ZgbymUmUOsiJiJiJiJdQLchLhLZg
ZgZbaVmUOshvhvhvhvMJErTahLZg
ZgmUmUgLmUZwKAgSpfoIErrZcbZg
ZgewTqmUEJlbRspGpBhLErsLSGZg
ZgfjqzCZZgaaZgZgZgZgZgNlWHZg
ZgCjnfBWZgjfoZpGEsZgIHmUmUZg
ZgCjRTVqZgJdRspGtdZgQNmUYGZg
ZgRbLnqsZgYcUadvYcZgpscyvRZg
ZgZgZgZgZgvJRsasJdZgZgZgZgZg
"}
